000000000
0X .    0
0000    U
000     0
000000000
